1 1 1 1 1 1 1 1
1 0 67 0 0 45 0 1
1 0 0 0 41 0 0 1
1 0 0 0 0 0 0 1
1 0 0 0 0 0 0 1
1 0 0 0 0 0 0 1
1 0 0 15 0 0 0 1
1 0 12 0 40 0 0 1
1 1 1 1 1 1 1 1
